# Map file for DC32 
# X
21,  1, 11,3,31,1, 65
21,  2, 11,3,31,1, 67 
21,  3, 11,3,31,1, 81 
21,  4, 11,3,31,1, 83 
21,  5, 11,3,31,1, 69 
21,  6, 11,3,31,1, 71 
21,  7, 11,3,31,1, 85 
21,  8, 11,3,31,1, 87 
21,  9, 11,3,31,1, 73 
21, 10, 11,3,31,1, 75 
21, 11, 11,3,31,1, 89 
21, 12, 11,3,31,1, 91 
21, 13, 11,3,31,1, 77 
21, 14, 11,3,31,1, 79 
21, 15, 11,3,31,1, 93 
21,  0, 11,3,31,1, 95
      
    
# X'
21, 17, 11,3,31,1, 97 
21, 18, 11,3,31,1, 99 
21, 19, 11,3,31,1, 113 
21, 20, 11,3,31,1, 115
21, 21, 11,3,31,1, 101
21, 22, 11,3,31,1, 103
21, 23, 11,3,31,1, 117
21, 24, 11,3,31,1, 119
21, 25, 11,3,31,1, 105
21, 26, 11,3,31,1, 107
21, 27, 11,3,31,1, 121
21, 28, 11,3,31,1, 123
21, 29, 11,3,31,1, 109
21, 30, 11,3,31,1, 111
21, 31, 11,3,31,1, 125
21, 16, 11,3,31,1, 127
      
# Y 
21, 33, 11,3,31,1,64 
21, 34, 11,3,31,1,66 
21, 35, 11,3,31,1,80 
21, 36, 11,3,31,1,82 
21, 37, 11,3,31,1,68
21, 38, 11,3,31,1,70
21, 39, 11,3,31,1,84
21, 40, 11,3,31,1,86
21, 41, 11,3,31,1,72
21, 42, 11,3,31,1,74
21, 43, 11,3,31,1,88
21, 44, 11,3,31,1,90
21, 45, 11,3,31,1,76
21, 46, 11,3,31,1,78
21, 47, 11,3,31,1,92
21, 32, 11,3,31,1,94
      
# Y'
21, 49, 11,3,31,1,96 
21, 50, 11,3,31,1,98 
21, 51, 11,3,31,1,112 
21, 52, 11,3,31,1,114 
21, 53, 11,3,31,1,100 
21, 54, 11,3,31,1,102 
21, 55, 11,3,31,1,116 
21, 56, 11,3,31,1,118 
21, 57, 11,3,31,1,104 
21, 58, 11,3,31,1,106 
21, 59, 11,3,31,1,120 
21, 60, 11,3,31,1,122 
21, 61, 11,3,31,1,108 
21, 62, 11,3,31,1,110 
21, 63, 11,3,31,1,124 
21, 48, 11,3,31,1,126













